4 4 4 4 4 4 4 4 4
4 0 5 0 5 0 9 8 4
4 0 5 0 0 5 0 4 4
4 0 0 4 4 4 4 4 4
4 4 0 2 0 2 4 4 4
4 4 0 0 2 0 0 4 4
4 4 4 4 4 0 1 4 4
4 4 4 4 4 4 4 4 4 

