4 4 4 4 4 4 4 4 4 4
4 0 0 0 0 0 2 0 4 4
4 7 4 3 4 3 4 0 4 4
4 4 4 0 0 2 3 3 4 4
4 4 4 3 4 3 4 0 0 4
4 4 4 0 3 3 0 0 1 4
4 4 4 4 4 4 4 6 4 4
4 4 4 4 8 8 8 9 4 4
4 4 4 4 4 4 4 4 4 4