4 4 4 4 4 4 4 4 4 4
4 4 0 5 0 5 0 4 4 4
4 0 5 0 5 0 5 5 9 4
4 5 0 5 0 5 5 9 8 4
4 0 5 3 10 0 6  4 4
4 1 4 7 0 5 4 4 4 4
4 4 4 4 4 4 4 4 4 4