4 4 4 4 4 4 4 4 4
4 4 4 4 4 8 9 2 4
4 1 0 4 4 9 2 0 4
4 0 0 4 4 0 3 0 4
4 0 3 4 4 10 10 5 4
4 4 2 4 3 3 0 0 4
4 4 0 0 0 0 4 4 4
4 4 4 4 4 4 4 4 4